1
12
1
13
0,0,0,0,0,0,0,0,0,0,0,0,0
0,0,17,16,17,16,4,4,8,16,8,0,8
0,0,10,18,10,18,3,3,16,17,0,0,0
0,0,0,17,16,17,4,4,8,18,8,18,8
0,18,10,18,10,18,3,3,17,16,17,16,17
0,16,17,16,17,16,4,4,8,18,8,18,8
0,17,10,17,10,17,3,0,16,17,16,17,16
0,4,3,4,3,4,3,3,4,3,4,3,4
0,9,18,9,18,9,4,4,17,16,17,16,17
0,16,17,16,17,16,3,3,18,10,18,10,18
0,9,0,9,18,9,4,4,16,17,16,17,0
0,0,0,17,16,17,3,3,18,10,18,10,0
0,9,0,9,17,9,4,0,4,17,16,17,0,0